
	 	NO	 		 	 		  ./path_to_the_north_texture.xpm

















	 	 F 				  	  	 255, 	 	 	 	  100, 		0	 	 	 	
	 	  	 	C 	 		  	225	 	 	 	,	 	 	 30,	 	 	 	 0
	 	 		 	 EA 	  	 ./path_to_the_east_texture.xpm







		 WE  	 	 ./path_to_the_west_texture.xpm



  SO 	 	 	 	 	 ./path_to_the_south_texture.xpm


















1111111111111111111111111111111                     
1000000000110000N00000001111101                         
10110000011100000000000000000111111                   
10010000000000000000000011111111101
1111111110110000011100000000000011
100000000011000001110111101111111
1110111111111011100000010001
111101111111110111010100100011
1100000011010101110000001000001
100000000000000011000000100011
1000000000000001101010010001
1100000111010101111101111000111
1111011101110101	1101111010001
11111111111111111101111111111111
1111111111111111111111111111