NO ./path_to_the_north_texture.xpm
SO ./path_to_the_south_texture.xpm
WE ./path_to_the_west_texture.xpm
EA ./path_to_the_east_texture.xpm
F 120 ,100,212

C 225,30,0


111111111111111111111111111
1N00000000110000000000000011
1111111011100000000000011111111
111111111111111111111111111111
100100000000000000000000111111111
111111111011000001110000000000001
100000000011000001110111111111111
11110111111111011100000010001
11110111111111011101010010001
11000000110101011100000010001
1000000000000000110000010001
11111111111111111111111111111
1111111011100000000000011111111
10111111111111111111111111111
111111111 1111111 111111111111